######
#...E#
#S..##
#....#
######